11111111111
1000C0000C1
10P01110011
100011E0001
11111111111