11111111
1P00C0C1
1000E0C1
11111111