111111111
10P00C001
100000P01
10000C001
111111111