111111111
10P00CE01
100000001
10E00C001
111111111