111111111
10P00C001
100000000
10E00C001
111111111