111111111
10P00C001
100000001
10000C001
111111111