111111111
10P000001
100000001
10E000001
111111111