111111111
10000C001
100000001
10E00C001
111111111