111111111
10P00C001
111100001
10E10C001
111111111