111111111
10P00C001
100000001
10E00C0011111
1111111111111